SO ./path_to_the_north_texture
EA ./path_to_the_south_texture
WE ./path_to_the_west_textures
NO ./path_to_the_east_texture

F 220,100,0
C 225,30,0            


       
11111111111011111111111               
10000000011000000000001
1011000001110000000000001
10010000000000000000000011111111
1111111110110000011100000000000011
00000000001100000111011111111111
11110111111111011100000010001111111
1111011111111011101010010001
11000000110101011100000010001
10000E00000000001100000010001
1000000000000001101010010001
11000001110111110111100011111
1111011111101011011110100011111111111
11111111111111111111111111111111111111
                                              