SO ./path_to_the_north_texture
EA ./path_to_the_south_texture
WE ./path_to_the_west_textures
NO ./path_to_the_east_texture

F 200,150,0
C 203,103,0

1111111111111111111111111               
100000000100000000000011
1011000001110000000000001
10010000000000000000000011111111
1111111110110000011100000000000011
100000000011000011101111111111111
11111011111101101110100001000111111
11111011111111011101 110010001
110000000110101011101000010001
10000E00000000001100000010001
1000000000000001101010010001
11000001110111110111100011111
111101111110101101111010001111111111
11111111111111111111111111111111111111
       
                                              